....................GG
....................GG
..........X.........GG
.......######.......GG
..G..............G..GG
####..G.G.G.G....###GG
.......G.G.GCG......GG
......--------......GG
....-...........-...GG
....................GG
.G.G............G.G.GG
####............####GG
....................GG
.1..................GG
######################
