....................GG
....................GG
....................GG
....................GG
....................GG
....................GG
....................GG
.........GGG........GG
.........###........GG
....................GG
....GGG.......GGG...GG
....###.......###...GG
....................GG
.1................G.GX
######################
